WWWWWWWWWWWWWWWWWWWWWWWWWWWWWW
W  Z   Z     WWWWWWWWWWWWWWWWW
W            W               W
W   Z    Z   W     C   C     W
W            W               W
WWWWWWWW     WWWWWWWWWWWWWWWWW
W                            W
W   C    C        P          W
W                            W
WWWWWWWWWWWWWWWWWWWWWWWWWWWWWW
