WWWWWWWWWWWWWWWWWWWWWWWWWWWWWW
W  Z                Z        W
W  W  WWWWWWWWWWWW  W        W
W  W  W          W  W        W
W  W  W  C  C C  W  W        W
W     W          W     P     W
W  W  WWWWW WWWWWW  W        W
W  Z  W          W  Z        W
W     W    C     W           W
W     WWWWWWWWWWWW           W
WWWWWWWWWWWWWWWWWWWWWWWWWWWWWW
