WWWWWWWWWWWWWWWWWWWWWWWWWWWWWW
WZ W Z W Z W Z W Z W Z W     W
W  W   W   W   W   W   W     W
W  W   W   W   W   W   WWWWWWW
W                            W
WWWWWWWWWWWWWWWWWWWWWWWWWWW  W
W  C  C  C  C  C  P          W
W WWWWWWWWWWWWWWWWWWWWWWWWWWWW
W  C  C  C  C  C             W
W                            W
WWWWWWWWWWWWWWWWWWWWWWWWWWWWWW
