WWWWWWWWWWWWWWWWWWWWWWWWWWWWWW
W  Z     Z     Z             W
W                            W
W   WWWWWW      WWWWWW       W
W   W    W      W    W       W
W   W C  W      W C  W  P   W
W   W    W      W    W       W
W   WWWWWW      WWWWWW       W
W                            W
W  Z     Z     Z             W
W                            W
W    C        C        C     W
WWWWWWWWWWWWWWWWWWWWWWWWWWWWWW
