WWWWWWWWWWWWWWWWWWWWWWWWWWWWWW
W                            W
W  Z                         W
W                            W
W            P               W
W                            W
W        C           C       W
W                            W
WWWWWWWWWWWWWWWWWWWWWWWWWWWWWW
