WWWWWWWWWWWWWWWWWWWWWWWWWWWWWW
W  Z   Z   Z   Z   Z         W
WWWWWWWWWWWWWWWWWWWWWWWW  WWWW
W                        C   W
W  WWWWWWWWWWWWWWWWWWWWWWWWWWW
W  W                         W
W  W  C   C   P   C   C      W
W  W                         W
W  WWWWWWWWWWWWWWWWWWWWWWWWWWW
W     Z  Z  Z  Z  Z      C   W
WWWWWWWWWWWWWWWWWWWWWWWWWWWWWW
