WWWWWWWWWWWWWWWWWWWWWWWWWWWWWW
W     W     Z    W     Z     W
W     W          W           W
W  C  WWWWW WWWWWW  C        W
W                            W
WWW  WWWWW   Z   WWWW  WWWWWWW
W Z   W          W    Z      W
W     W    P     W           W
WWWWWWW WWWWWWWWWW WWWWWWWWWWW
W    C           C    C      W
W  Z     WWWWW       Z       W
W C      W     C     W  C    W
WWWWWWWWWWWWWWWWWWWWWWWWWWWWWW
