WWWWWWWWWWWWWWWWWWWWWWWWWWWWWW
WZ  Z  Z  Z  WWWWWW  Z  Z  ZW
W              W             W
W   WWWWWWWW   W   WWWWWWW   W
W   W      W       W     W   W
W   W C C  W   W   W C C W   W
W   WWWWWWWW   W   WWWWWWW   W
W              W             W
W  P   C C   WWWW   C C      W
W              W             W
W   WWWWWWWW   W   WWWWWWW   W
W   W      W       W     W   W
W Z W Z  Z W Z W Z W Z Z W Z W
W   W      W       W     W   W
WWWWWWWWWWWWWWWWWWWWWWWWWWWWWW
