WWWWWWWWWWWWWWWWWWWWWWWWWWWWWW
W Z  Z             Z  Z      W
W                            W
W WWWWWWWWWWWWWWWWWWWWWWWWWW W
W W                        W W
W W  C   C   P   C   C     W W
W W                        W W
W WWWWWWWWWWWWWWWWWWWWWWWWWW W
W                            W
W Z  Z             Z  Z      W
WWWWWWWWWWWWWWWWWWWWWWWWWWWWWW
