WWWWWWWWWWWWWWWWWWWWWWWWWWWWWW
W     Z              Z       W
W                            W
W          WWWWWW            W
W                            W
W    C          C    C       W
W                            W
W         P                  W
W                            W
WWWWWWWWWWWWWWWWWWWWWWWWWWWWWW
